*****************
***           ***
***      *    ***
***     P*    S**
***      *    ***
***      *    ***
***      *    ***
*****************